6
111101
110011
100001
111101
100001
100001