20
11111111111111111111
10101001101111110111
10101001101111110111
10101001101111110111
10101001101111011111
10101001101110111111
10101001101110111111
10101001101110111111
10101001101110111111
10101001111110111111
10000000000000000001
10101001101001101111
10101001101011101111
10101001101110101111
10101001101011001111
10101001101010101111
10101001101010111111
10101001101010111111
10101001101010111111
10101001111010111111